1111111111111111111111111111111111
11P000000C000000000000000000000001
10000C0100100100101001000001010101
1110111111111100001001000010110101
10000000000000C00000C0000001E00001
1111111111111111111111111111111111