1111111111111111111111111
100000000000C000000000001
1011111111111101111111101
1000000000000001C00000001
10111111C1111111011111101
1000000001000000000000001
1011111111011111111111101
1000000000010000000000001
1111101111011111110111111
1000100000000000000010001
1111101111111101110111111
1000000000000001000000001
1011111101111111011111101
100000000EPC0000001C00001
1011111111111111111111101
1000000C00000000000000001
1111111111111111111111111