111111111111111111111111111111111111
1000C0001111111100C00000000000000C01
10111110000000C101111111111111110001
100000000011111100000000000000110001
101111110000001111111111111110110001
100000000111100000000000000000010001
101111100000001111111111111111010001
100000000111111100000000000000010001
101111110000000011111111111110110001
1000000000C000000000C000000000010001
101111111111111111111111110000010001
1000P0000C0000000000C000000C0E000001
111111111111111111111111111111111111